1590;561;1
1590;60;1
1590;59;1
1401;59;1
1400;59;1
1400;69;1
1400;70;1
1580;70;1
1581;70;1
1581;570;1
1581;571;1
1700;571;1
1701;571;1
1701;562;1
1701;561;1
1591;561;1